cat	Kass
dog	Koer
sun	Päike
chair	Tool
environment	Keskkond
scrum	Scrum
team	Tiim
window	Aken
university	Ülikool
milk	Piim
tea	Tee
coffee	Kohv
hole	Auk
programming	Programmeerimine
fast	Kiire
slow	Aeglane
medium	Keskmine
high	Kõrge
low	Madal
between	Vahel